Found 270 items with no refs:

Ab	Ab	Hebrew month
Adar	Adar	Hebrew month
AdriaticSea	Adriatic Sea	
Africa	Africa	
Alexandria	Alexandria	
Altar	Altar	
AntoniaFortress	Antonia Fortress	
Appearance	Appears after resurrection (Lk 24)	
Apr	Apr	3 letter abbreviation for the month
Aqueduct	Aqueduct	
ArabianDesert	Arabian Desert	
ArabianSea	The Arabian Sea	
ArakSea	Arak Sea	
Ascension	Discourse; ascension (Ac 1)	
AtlanticOcean	Atlantic Ocean	
Aug	Aug	3 letter abbreviation for the month
Australia	Australia	
Avaris	Avaris	
BeautifulGate	Beautiful Gate	
Belgica	Belgica	
BellsHp	Bells	
BethShean	Beth Shean	
Birthplace	Birthplace (Mt 2)	
BlackSea	Black Sea	
Blindman	Blind man healed (Mk 8)	
Boundary	Boundary between Israel and Judah	
BoundaryPersia	Boundary of the Persian Empire	
BoundaryRome	Boundary of the Roman Empire	
BreastplateHp	Breastplate with 12 Jewels	
Bridge	bridge	
Britannia	Britannia	
Cadiz	Cadiz	
Carthage	Carthage	
Caspia	Caspia	
CaspianSea	Caspian Sea	
Chanukah	Chanukah	Hebrew month
CitiesRebuked	Cities rebuked (Lk 10)	
Confession	Peter’s Confession (Mt 16)	
Corsica	Corsica	
CouncilChamber	Council Chamber	
CourtOfGentiles	Court of the Gentiles	
CourtOfIsrael	Court of Israel (Court of Men)	
CourtOfPriests	Court of Priests	
CourtOfWomen	Court of Women	
Curtain	Curtain	hanging fabric
CurtainWall	Curtain Wall	a wall made of fabric
Cyrenaica	Cyrenaica	
DamascusGate	Damascus Gate	
DanubeRiver	Danube River	
DaughterHealed	Syro-Phoenician woman’s daughter healed (Mk 7)	
Dec	Dec	3 letter abbreviation for the month
Demoniac	Demoniac healed (Mk 5)	
East	East	the compass direction East
Elul	Elul	Hebrew month
Endor	Endor	
EnrogelSpring	Enrogel Spring	
Entrance	The Entrance	
EphodHp	Ephod	
EsseneGate	Essene Gate	
Etham	Etham	location along the route of the Exodus
Europe	Europe	
Feb	Feb	3 letter abbreviation for the month
FeetHp	Bare Feet	
ForumJerusalem	Forum	
GardenGate	Garden Gate	
Gate	Gate	an opening or entrance to a building, city, or other structure
Gaul	Gallia (Gaul)	
GreatSea	The Great Sea	
GulfOfAqaba	Gulf of Aqaba	
HeadbandHp	Gold Headband	
Headquarters	Headquarters, site of many miracles (Mk 2)	
Heliopolis	Heliopolis	
HerodAntipasPalace	Herod Antipas’ Palace	
HerodianStreet	Herodian Street	
HerodsPalace	Herod’s Palace	
HezekiahsTunnel	Hezekiah’s Tunnel	
HolyHoly	The Holy of Holies	
HolyLandMap	Holy Land map	
HolyPlace	The Holy Place	
Home	Boyhood home (Lk 2)	
HouseOfCaiaphas	House of Caiaphas	
Hurrians	Hurrians	
IncenseHp	Incense Burner	
IndianOcean	Indian Ocean	
IndusRiver	Indus River	
InnerCourt	Inner Court	
InnerNorthGate	Inner North Gate	
IsraelPool	Israel Pool	
Iyar	Iyar	Hebrew month
JacobsWell	Jacob’s Well	
Jamnia	Jamnia	
Jan	Jan	3 letter abbreviation for the month
JaxartesRiver	Jaxartes River	
JerusalemTitle	Jerusalem in New Testament Times	
Jul	Jul	3 letter abbreviation for the month
Jun	Jun	3 letter abbreviation for the month
Kislew	Kislew	Hebrew month
Laver	Laver	a large basin or bowl used for ceremonial washing
Lazarus	Home of Mary, Martha and Lazarus (Jn 11)	
Legend1	1. Paul’s First Journey (Acts 13:4–14:28)	
Legend2	2. Paul’s Second Journey (Acts 15:36–18:22)	
Legend3	3. Paul’s Third Journey (Acts 18:23–21:17)	
Legend4	4. Paul’s Journey to Rome (Acts 27:1–28:16)	
Lepers	Lepers healed (Lk 17)	
LeptisMagna	Leptis Magna	
Londinium	Londinium	
MaccabeanPalace	Maccabean Palace	
MainGate	Main Gate	
ManassehWest	Manasseh (West)	son of Joseph; founder of tribe of Manasseh
Mar	Mar	3 letter abbreviation for the month
Mari	Mari	
Markhesywan	Markhesywan	Hebrew month
Mauretania	Mauretania	
May	May	3 letter abbreviation for the month
MediterraneanSea	Mediterranean Sea	
MizpahOfMoab	Mizpah of Moab	
MountOfOlives	Mount of Olives	
Nippur	Nippur	
Nisan	Nisan	Hebrew month
North	North	
NorthAmerica	North America	
NorthSea	North Sea	
Nov	Nov	3 letter abbreviation for the month
Numidia	Numidia	
Nuzi	Nuzi	
Oct	Oct	3 letter abbreviation for the month
OnyxHp	Onyx Stones on Shoulders	
OrontesRiver	Orontes River	
OuterCourtRooms	Outer Court Rooms	
OuterEastGate	Outer East Gate	
OuterNorthGate	Outer North Gate	
OuterSouthGate	Outer South Gate	
OxusRiver	Oxus River	
PacificOcean	Pacific Ocean	
Palestine	Palestine	
Paris	Paris	
Parthia	Parthia	
PassionWk	Several visits; passion week (Jn 12)	
PaulsJourneyMap	Paul’s Journeys map	
Peraea	Peraea	
PersiaTitle01	The Persian Empire during the time of Esther	
PersianGulf	Persian Gulf	
PhilipstravelsTitle	Philip’s Travels	
PinnacleOfTemple	Pinnacle of Temple	
Poles	Poles	long, round pieces of wood used to support something
PossibleRteExodus	Possible route of the Exodus	
PriestsHouses	Priest’s Houses	
Purim	Purim	Hebrew holiday
Quantir	Quantir	
Rameses	Rameses	City in Egypt.
RefugecitiesTitle01	The Cities of Refuge	
RefugecitiesTitle02	(Numbers 35 and Joshua 20)	
RiverOfLife	River of Life	
RiverYarmuk	Yarmuk River	
RoadToBethany	Road to Bethany	
RoadToBethlehem	Road to Bethlehem	
RoadToCaesarea	Road to Caesarea	
RoadToJericho	Road to Jericho	
RoadToJoppa	Road to Joppa	
RoadToTheDeadSea	Road to the Dead Sea	
RobeHp	Robe	
RouteRuth	Journey from Israel to Moab and back	
RoyalPorch	Royal Porch	
RtFrmEgyptToArabia	Route from Egypt to Arabia	
Sardinia	Sardinia	
SashHp	Sash	
ScaleK	Kilometers	
ScaleM	Miles	
Sept	Sept	3 letter abbreviation for the month
SerpentsPool	Serpent’s Pool	
Shavot	Shavot	Hebrew holiday
SheepGate	Sheep Gate	
Shittim	Shittim	A large area in the plains of Moab directly across from Jericho, immediately east of the Jordan River.
Sicily	Sicily	
Siwan	Siwan	Hebrew holiday
SolomonsPool	Solomon’s Pool	
SolomonsPorch	Solomon’s Porch	
South	South	the compass direction South
SouthAmerica	South America	
South-eastKitchen	South-east Kitchen	
South-westKitchen	South-west Kitchen	
Spain	Hispania (Spain)	
Stairs	stairs	
Storm	Quiets storm (Mt 8)	
Sukkot	Sukkot	Hebrew holiday
Syebat	Syebat	Hebrew holiday
Tamus	Tamus	Hebrew holiday
TaurusMtns	Taurus Mtns	
Tebet	Tebet	Hebrew holiday
Temple	Temple	
Temple1Table	The Table of Showbread	
Temple2Lamp	The Lampstand	
Temple3Altar	The Altar of Incense	
Temple4Curtain	The Curtain	
Temple5Ark	The Ark of the Covenant	
Temple6Cherubim	The Cherubim	
TheBuilding	The Building	
Theater	Theater	
Thrace	Thrace	
ThreeTaverns	Three Taverns	
Tisyri	Tisyri	Hebrew holiday
Title7church	Seven Churches of Asia	
TitleAbrahamToCanaan	Abraham’s Journey to Canaan	
TitleAbrahamToEgypt	Abraham Goes to Egypt	
TitleAfrica	Africa	
TitleAncient	The Ancient World (Abraham’s World)	
TitleCanaanhg	Land of Canaan	
TitleChristsministry	Events in Christ’s Ministry	
TitleConquest	The Conquest of Canaan	
TitleDn	The Descendants of Noah	
TitleExodus	The Exodus from Egypt	
TitleEzekielTemple	Ezekiel’s Temple	
TitleHoly	The Holy Land in the Time of Jesus Christ	
TitleHp	High Priest	
TitleJ0	Paul’s Missionary Journeys	
TitleJ1	Paul’s First Journey	
TitleJ2	Paul’s Second Journey	
TitleJ3	Paul’s Third Journey	
TitleJ4	Paul’s Journey to Rome	
TitleJacob2haran	Jacob’s Trip to Haran	
TitleJacobreturns	Return of Jacob	
TitleJerusalemIll	Jerusalem in the Time of Christ	
TitleJewishCalendar	Jewish Calendar	
TitleKingdoms	Kingdoms of Israel and Judah	
TitleMed	The Mediterranean Area	
TitlePent	Nations Whose Languages Were Heard at Pentecost	
TitleRomanEmpire	The Roman Empire during the time of Christ	
TitleRuth	Israel and Moab at the time of Naomi and Ruth	
TitleTemple1	The Temple in the Time of Jesus Christ	
TitleTemple2	The Temple Buildings	
TitleTemple3	The Temple Itself	
TitleWorld	Map of the World	
TitleWorldsimple	The World	
Tombs	Tombs	
TowerOfAntonia	Tower of Antonia	
TowersPool	Tower’s Pool	
TradeRoutes	Trade routes	
Transfiguration	Transfiguration? (Mk 9)	
TuBav	Tu B’Av	Hebrew holiday
TuBishvat	Tu BiShvat	Hebrew holiday
TunicHp	Tunic of Fine Linen	
TurbanHp	Special Turban	
TyropoeonValley	Tyropoeon Valley	
Ugarit	Ugarit	
UnleavenedBread	Unleavened Bread	thin cracker-like bread made without yeast
UnsucInvOfCanaan	Unsuccessful invasion of Canaan	
UpperRoom	Upper Room	
ValleyGate	Valley Gate	
WallAgrippa	Walls built by Agrippa I	
WallJesus	Walls at the time of Jesus	
WallPresent	Present day wall	
WallUncertain	Wall of uncertain date	
WaterGate	Water Gate	
WayOfThePhilistines	Way of the Philistines	
Well	Woman at the well (Jn 4)	
West	West	the compass direction West
WidowsSon	Widow’s son raised (Lk 7)	
Wine	Water turned to wine (Jn 2)	
YomKippur	Yom Kippur	Hebrew holiday
YomTeruah	Yom Teruah	Hebrew holiday
YourCountry	Your Country	
Zacchaeus	Visits Zacchaeus (Lk 19)	
TitleActs8	Acts Chapter 8	
BrookBesor	Brook Besor	
TitleSamuelDavid	Cities In The Time of Samuel and David	
TitleGalilee	Galilee at the time of Jesus	
TitleIsraelTribes	Israel's Tribal Borders	
TitleExodusAndCanaan	The Exodus and Canaan	
TitleSamuelToDavid	Time of Samuel to David	
RomeCountry	Rome	
